%s ago=před %s
%s used of %s %s %%=%s použito z %s (%s %%)
10 s=10 s
30 s=30 s
1 m=1 m
2 m=1 m
Active tunnels=Aktivní tunely
Activity=Aktivita
ago=před
Airflow=Tok vzduchu
All Apps=Všechny aplikace
All VMs=Všechny virtuální stroje
Battery charge=Kapacita baterie
BIOS dated=Datum BIOSu
Click to toggle CPU chart=Klepnutím přepnete graf procesoru
Click to toggle details=Klepnutím přepnete detaily
Completed=Hotovo
Counters info=Informace počítadel
Current operation %s on %s=Současná operace %s na **%s**
custom image=vlastní obraz
Data is invalid=Data jsou neplatná
default image=výchozí obraz
Docker Containers=Kontejnery Dockeru
Due in=Za
Elapsed time=Uplynulý čas čas
Errors info=Informace o chybách
Estimated finish=Odhadované dokočení
failed device=selhávající zařízení
Fan count=Počet ventilátorů
FAN=VENTILÁTOR
Finding %s error=Našla se: **%s** chyba
Finding %s errors=Našlo se: **%s** chyb
General info=Obecné informace
Go to CPU pinning settings=Přejít na nastavení připnutí procesorů
Go to disk settings=Přejít na nastavení disku
Go to Docker settings=Přejít na nastavení Dockeru
Go to fan settings=Přejít na nastavení ventilátorů
Go to identification settings=Přejít na nastavení identifikace
Go to network settings=Přejít na nastavení sítě
Go to scheduler settings=Přejít na nastavení plánovače
Go to Share settings=Přejít na nastavení sdílení
Go to UPS settings=Přejít na nastavení UPS
Go to User settings=Přejít na nastavení uživatelů
Go to VM settings=Přejít na nastavení virtuálních strojů
Go to VPN settings=Přejít na nastavení VPN
Handshake=Vyjednání
has=má
healthy=zdravý
heat warning=varování teploty
Hide details=Skrýt detaily
in progress=probíhá
Inactive tunnels=Neaktivní tunely
inactive=neaktivní
Inbound=Příchozí
invalid device=Neplatné zařízení
invalid devices=Neplatná zařízení
Last check completed on %s=Poslední kontrola dokončena **%s**
Last check incomplete on %s=Poslední kontrola nedokončena **%s**
Last checked on %s=Poslední kontrola provedena **%s**
Maximum size=Maximální velikost
Mode of operation=Provozní režim
Network traffic=Síťový provoz
Next check scheduled on %s=Další je plánovaná na **%s**
No docker containers defined=Nejsou definovány žádné kontejnery Dockeru
No running docker containers=Neběží žádné kontejnery Dockeru
No running virtual machines=Neběží žádné virtuální stroje
No shares present=Nejsou přítomna žádná sdílení
No virtual machines defined=Nejsou definovány žádné virtuální stroje
Nominal power=Nominální výkon
not received=nepřijmuto
Only PNG images are allowed=Jsou povoleny pouze obrázky PNG
Outbound=Odchozí
Overall Load=Celkové zatížení
Parity disk not present=Není přítomen paritní disk
Parity disks not present=Nejsou přítomny paritní disky
Parity has not been checked yet=Parita ještě nebyla zkontrolována
Parity is degraded=Parita je porušená
Power=Výkon
Put system to sleep=Uspat systém
Reboot the system=Restartovat systém
Receive counters=Počítadla přijatých
Received packets=Přijaté pakety
Runtime left=Zbývající doba běhu
Scheduled parity check is disabled=Naplánovaná kontrola parity je zakázána
Select Case Model=Zvolte model skříně
Select time frame=Zvolte časový rámec
Share count %s with %s cache only and %s encrypted=Počet sdílení: %s, %s s pouze mezipaměť a %s šifrovaných
Show details=Zobrazit detaily
Show Information=Zobrazit informace
Shutdown the system=Vypnout systém
SMART error=Chyba SMART
SMART health-check failed=Kontrola zdraví SMART selhala
SMART=SMART
sn=s.č.
Start the array=Spustit pole
Started only=Spuštěno pouze
Stop the array=Zastavit pole
Temp=Teplota
This will put the system to sleep=Tímto uspíte systém
This will reboot the system=Tímto restartujete systém
This will shutdown the system=Tímto vypnete systém
This will start the array=Tímto spustíte pole
This will stop the array=Tímto vypnete pole
Transmit counters=Počítadla přenesených
Transmitted packets=Přenesené pakety
UPS Load=Zátěž UPS
UPS status=Stav UPS
Usable size=Použitelná velikost
User count %s with %s unprotected=Počet uživatelů: %s s %s nechráněných
utilization warning=varování využití
View Running Processes=Zobrazit běžící procesy
Virtual Machines=Virtuální stroje
