3rd Party=Od třetí strany
Access Mode=Režim přístupu
Add another Path, Port, Variable, Label or Device=Přidat další cestu, port, proměnnou, štítek nebo zařízení
Add Configuration=Přidat konfiguraci
Add=Přidat
Additional Requirements=Další požadavky
Addresses=Adresy
Always=Vždy
App to Host=Aplikace na hostiteli
Application=Aplikace
apply update=Použít aktualizaci
Are you sure=Jste si jistý?
Array must be Started to view Docker containers=Pole musí být spuštěné, abyste mohli zobrazit Docker kontejnery
Autostart=Automatické spuštění
available=dostupné
Back=Zpět
Backup=Záloha
Beta=Beta
Books=Knihy
By=Od
Categories=Kategorie
Check for Updates=Zkontrolovat aktualizace
Cloud=Cloud
Compose=Sestavit
Config Type=Typ konfigurace
Configuration not found=Konfigurace nebyla nalezena
Connection Type=Typ připojení
Console shell command=Příkaz do konzole
Container ID=ID kontejneru
Container IP=IP adresa kontejneru
Container not running=Kontejner neběží
Container Path=Cesta kontejneru
Container Port=Port kontejneru
Container Size=Velikost kontejneru
Container=Kontejner
CPU Memory load=Zatížení CPU / paměti
CPU Pinning=Přiřazení CPU
Created=Vytvořeno
Crypto Currency=Kryptoměna
Default Value=Výchozí hodnota
DERP Relay=DERP přesměrování
Device=Zařízení
Display=Zobrazení
DNS=DNS
Docker Containers=Docker kontejnery
Docker Hub URL=URL Docker Hubu
Docker Service failed to start=Službu Docker se nepodařilo spustit
Downloaders=Nástroje pro stahování
Drivers=Ovladače
Edit Configuration=Upravit konfiguraci
Error gathering Tailscale information from container=Chyba při získávání informací o Tailscale z kontejneru
Exit Node=Koncový uzel
Exited=Ukončeno
Extra Parameters=Další parametry
Fixed IP address=Statická IP adresa
force update=Vynutit aktualizaci
FTP=FTP
Game Servers=Herní servery
healthy=Zdravý
Hide Buttons=Skrýt tlačítka
Hide docker allocations=Skrýt přiřazení Dockeru
Hide more settings=Skrýt další nastavení
Home Automation=Domácí automatizace
Host Path=Cesta na hostiteli
Host Port=Port hostitele
Hostname=Název hostitele
HT=HT (Hyper-Threading)
Icon URL=URL ikony
Image ID=ID obrazu
Is Exit Node=Je koncový uzel
Key Expiry=Platnost klíče
Key=Klíč
Label=Popisek
LAN IPPort=LAN IP:Port
Lock sortable items=Zamknout položky k řazení
Management=Správa
MediaApp=Mediální aplikace
MediaServer=Mediální server
Messenger=Komunikátor
Missing parameters=Chybějící parametry
Music=Hudba
Network Type=Typ sítě
No Docker containers installed=Nejsou nainstalovány žádné Docker kontejnery
None Listed=Žádné uvedeny
of=z
Online=Online
orphan image=Osiřelý obraz
Other=Ostatní
Overview=Přehled
Path=Cesta
Pause All=Pauza všeho
Photos=Fotografie
Please check the logs and refresh the page=Zkontrolujte logy a obnovte stránku
Please check the logs=Zkontrolujte logy
Port Mappings=Mapování portů
Port=Port
Post Arguments=Post argumenty
Privileged=S privilegii
Productivity=Produktivita
Project Page=Stránka projektu
Proxy=Proxy
Pulling image=Stahuji obraz
Read Me First=Nejprve si přečtěte
Read Only - Shared=Jen pro čtení – sdílené
Read Only - Slave=Jen pro čtení – podřízené
Read Only=Jen pro čtení
ReadWrite - Shared=Čtení/Zápis – sdílené
ReadWrite - Slave=Čtení/Zápis – podřízené
Real Hostname=Skutečný název hostitele
rebuild ready=Připraveno k přestavbě
rebuilding=Probíhá přestavba
Remove template=Odstranit šablonu
Removing container=Odstraňování kontejneru
Removing orphan image=Odstraňování osiřelého obrazu
Repository=Repozitář
Required=Vyžadováno
Reset sorting=Obnovit řazení
Resume All=Obnovit vše
Routes=Trasy
Save=Uložit
Select a template=Vyberte šablonu
Select categories=Vyberte kategorie
Show docker allocations=Zobrazit přiřazení Dockeru
Show more settings=Zobrazit více nastavení
Stable=Stabilní
Start All=Spustit vše
starting up containers=Spouštění kontejnerů
Stop All=Zastavit vše
Stopping container=Zastavuji kontejner
Successfully removed container=Kontejner byl úspěšně odstraněn
Successfully removed orphan image=Osiřelý obraz byl úspěšně odstraněn
Successfully stopped container=Kontejner byl úspěšně zastaven
Support Thread=Vlákno podpory
Tailscale=Tailscale
Template URL=URL šablony
Template=Šablona
The command failed=Příkaz selhal
The command finished successfully=Příkaz byl úspěšně dokončen
TOTAL DATA PULLED=CELKOVĚ STAŽENO DAT
Total size=Celková velikost
Unknown action=Neznámá akce
Unlock sortable items=Odemknout položky k řazení
Update All=Aktualizovat vše
update available=Aktualizace dostupná
update ready=Připraveno k aktualizaci
URL=URL
Value=Hodnota
Variable=Proměnná
Video=Video
Video=Video
Voip=VoIP
Volume Mappings=Mapování svazků
wait=Čekejte
Was this container created using this plugin=Byl tento kontejner vytvořen pomocí tohoto pluginu?
Web=Web
WebUI=WebUI
Writable=Zapisovatelný

; Note: April 21, 2025 - 3 missing translations
Container not found Try reloading this page to fix=Kontejner nebyl nalezen. Zkuste znovu načíst tuto stránku.
Expired RenewDisable key expiry=Platnost vypršela! Obnovte nebo zakažte vypršení klíče.
For security reasons, containers with Network Type Host should not have Tailscale enabled Please disable Tailscale in this container or change the Network Type of the container=Z bezpečnostních důvodů by kontejnery s typem sítě „Host“ neměly mít povolený Tailscale. V tomto kontejneru prosím zakažte Tailscale nebo změňte typ sítě.
