Add Share=Přidat sdílení
All files encrypted=Všechny soubory zašifrovány
All files protected=Všechny soubory chráněny
All files unprotected=Všechny soubory nechráněny
Allocation method=Metoda alokace
Array must be Started to view Shares=Pro zobrazení sdílení musí být pole **spuštěné**
Automatically split any directory as required=Automaticky rozdělit složky podle potřeby
Automatically split only the top five directory levels as required=Automaticky rozdělit podle potřeby pouze vrchních pět úrovní složek
Automatically split only the top four directory levels as required=Automaticky rozdělit podle potřeby pouze vrchní čtyři úrovně složek
Automatically split only the top level directory as required=Automaticky rozdělit podle potřeby pouze vrchní úroveň složek
Automatically split only the top three directory levels as required=Automaticky rozdělit podle potřeby pouze vrchní tři úrovně složek
Automatically split only the top two directory levels as required=Automaticky rozdělit podle potřeby pouze vrchní dvě úrovně složek
Comments=Komentáře
Compute All=Spočítat vše
Compute=Spočítat
Disk Shares=Disková sdílení
Do not use reserved names=Nepoužívejte vyhrazené názvy
Do not use pool names=Nepoužívejte názvy diskových fondů
Enable Copy-on-write=Povolit kopírování při zápisu
Enter a name for the share=Zadejte název sdílení
Excluded disks=Vynechané disky
Export=Exportovat
Fill-up=Zaplněno
Free=Volno
has been deleted=byl smazán
HDD=HDD
High-water=Velká voda
Included disks=Zahrnuté disky
Invalid Characters=Neplatné znaky
Invalid share name=Neplatný název sdílení
Manual do not automatically split directories=Ručně: složky automaticky nerozdělovat
Minimum free space=Minimální volné místo
Missing share name=Chybí název sdílení
Most-free=Nejvíce volného místa
Mover takes no action=Přesouvač nebude nic dělat
Mover transfers files from array to cache=Přesouvač přesune soubory z pole do mezipaměti
Mover transfers files from cache to array=Přesouvač přesune soubory z mezipaměti do pole
next user share=další uživatelské sdílení
Only=Pouze
Prefer=Upřednostnit
previous user share=předchozí uživatelské sdílení
Read=Čtení
Recompute=Přepočítat
Rule=Pravidlo
Select cache pool=Vyberte fond mezipaměti
Set when adding new share only=Nastavit pouze když přidáváte nové sdílení
Share contains data=Sdílení obsahuje data
Share is empty=Sdílení je prázdné
Share is outside the list of designated disks=Sdílení je mimo seznam zahrnutých disků
Share Settings=Nastavení sdílení
Share status=Stav sdílení
Size=Velikost
Some or all files unencrypted=Některé, nebo všechny soubory jsou šifrované
Some or all files unprotected=Některé, nebo všechny soubory nejsou chráněné
Split level=Úroveň rozdělení
SSD=SSD
There are no exportable disk shares=Žádné disky nejsou dostupné pro export jako sdílení
There are no exportable user shares=Nejsou žádná exportovatelná uživatelská sdílení
Time Machine volume size limit=Limit velikosti oddílu Time Machine
Unknown encryption state=Neznámý stav šifrování
Use cache pool for new filesdirectories=Použít fond mezipaměti (pro nové soubory/složky)
User Shares=Uživatelská sdílení
Write=Zápis
You cannot use the following within share names=V názvu sdílení nemůžete použít následující
