20 EHCI=2.0 (EHCI)
30 nec XHCI=3.0 (nec XHCI)
30 qemu XHCI=3.0 (qemu XHCI)
Allocation=Příděl
and if using graphics device passthrough it too needs UEFI=a pokud použijete průchod grafické karty, také potřebuje UEFI
Are you sure=Jste si jistí
Array must be started to view Virtual Machines=Pro zobrazení virtuálních strojů musí být pole **spuštěné**
Autostart=Autostart
Back=Zpět
Bus=Sběrnice
Capacity=Kapacita
Change Icon=Změnit ikonu
Cleanup=Vyčistit
Click and Select cdrom image to install operating system=Klepněte a vyberte obraz média pro instalaci operačního systému
Config Folder=Složka konfigurace
Copy Paste Domain XML Configuration Here=Sem vložte XML nastavení domény
CPU Mode=Režim procesoru
CPUs=Procesory
Create=Vytvořit
Creating=Vytvářím
define the amount memory=definujte velikost paměti
define the maximum amount of memory=definujte maximální velikost paměti
define type of cpu presented to this vm=definujte typ procesoru poskytnutého tomuto virtuálnímu stroji
description of virtual machine=popis virtuálního stroje
Disk devices=Disková zařízení
Download Folder=Složka pro stažení
Download, Click and Select virtio drivers image=Stáhni, klepni a vyber obraz ovladačů virtio
Downloading=Stahuji
eg=např.
Emulated=Emulovaný
ETA=Zbývající čas
Extracting=Rozbaluji
Folder to save the LibreELEC image to=Složka pro uložení obrazu LibreELEC
Folder to save the OpenELEC image to=Složka pro uložení obrazu OpenELEC
Form View=Formulářový náhled
free=volné
Graphics Card=Grafická karta
Graphics ROM BIOS=ROM BIOS grafické karty
Graphics=Grafika
Guest not running or guest agent not installed=Host neběží, nebo není nainstalovaný agent hosta
Host Passthrough=Průchod z hostitele
Hyperv tweaks for Windows=Vyladění Hyper-V pro Windows
Hyper-V=Hyper-V
i440fx will work for most=i440fx bude většinou fungovat
Icon=Ikona
Initial=Výchozí
Interfaces=Rozhraní
Invalid storage path=Neplatná cesta úložiště
Invalid VM to edit=Neplatný virtuální stroj pro editaci
IP Address=IP adresa
ISO storage path doesnt exist=Cesta pro uložení ISO obrazů neexistuje
ISO storage path doesnt exist, please create the user share or empty folder first=ISO storage path doesn't exist, please create the user share (or empty folder) first
ISO storage path was empty=Cesta pro uložení ISO obrazů je prázdná
keyboard for VNC=klávesnice pro VNC
LibreELEC Version=Verze LibreELEC
LibreELEC=LibreELEC
Libvirt Service failed to start=Nastala chyba při spouštění služby Libvirt
Logical CPUs=Logické procesory
Machine=Stroj
Manual=Ruční
Max=Maximální
MD5 verification failed, your download is incomplete or corrupted=Ověření součtu MD5 nebylo úspěšné, stahování je buď nekompletní, nebo poškozené
mount tag inside vm=značka připojení uvnitř virtuálního stroje
My Workstation=Moje pracovní stanice
name of mount tag inside vm=název značky připojení uvnitř virtuálního stroje
Name of virtual machine=Název virtuálního stroje
Network Bridge=Síťový most
Network MAC=MAC adresa
Network Model=Síťový model
No Virtual Machines installed=Nejsou instalovány žádné virtuální stroje
None available=Žádné nejsou dostupně
Not enough free space, need at least=Nedostatek volného místa. Je potřeba alespoň
Not running=Neběží
OpenELEC Version=Verze OpenELEC
OpenELEC=OpenELEC
OS Install CDRom Bus=Sběrnice CD-Romky pro instalaci OS
OS Install ISO=ISO obraz pro instalaci OS
Other PCI Devices=Další PCI zařízení
OVMF requires a UEFI-compatable OS=OVMF vyžaduje OS kompatibilní s UEFI
OVMF=OVMF
OVMF TPM=
password for VNC=heslo pro VNC
path of Unraid share=Cesta Unraid sdílení
path on Unraid share to save LibreELEC settings=Cesta na Unraid sdílení pro uložení nastavení LibreELEC
path on Unraid share to save OpenELEC settings=Cesta na Unraid sdílení pro uložení nastavení OpenELEC
Path to ROM BIOS file=Cesta k soubor ROM BIOS
Please choose a folder the LibreELEC image will download to=Vyberte prosím složku do které bude stažen obraz LibreELEC
Please choose a folder the OpenELEC image will download to=Vyberte prosím složku do které bude stažen obraz OpenELEC
Pop-up Blocker is enabled Please add this site to your exception list=Pop-up Blocker is enabled! Please add this site to your exception list
Prefix=Předpona
Primary=Primární
Q35 for a newer machine model with PCIE=Q35 pro novější model stroje s PCIE
QEMU64=QEMU64
random mac, you can supply your own=náhodná mac adresa, můžete vložit vlastní
re-generate random mac address=znovu vygenerovat mac adresu
Remove LibreELEC image=Odstranit obraz LibreELEC
Remove OpenELEC image=Odstranit obraz OpenELEC
Remove this LibreELEC file=Odstranit tento soubor LibreELEC
Remove this OpenELEC file=Odstranit tento soubor OpenELEC
SeaBIOS will work for most=SeaBIOS bude většinou fungovat
SeaBIOS=SeaBIOS
Select the BIOS=Vyberte BIOS
Select the LibreELEC version to use=Vyberte verzi LibreELEC
Select the machine model=Vyberte model stroje
Select the OpenELEC version to use=Vyberte verzi OpenELEC
Select the USB Controller to emulate=Vyberte USB řadič pro emulaci
Separate sub-folder and image will be created based on Name=Oddělte podsložku a obraz bude vytvořen na základě názvu
shares=sdílení
Some OSes wont support USB3=Některé OS nepodporují USB3
Sound Card=Zvuková karta
Specify a ISO storage path first=Nejdříve zadejte cestu k úložišti ISO obrazů
Start All=Spustit všechny
Start VM after creation=Po vytvoření spustit virtuální stroj
Stop All=Zastavit všechny
Toggle VM autostart=Přepnout autostart virtuálních strojů
type of storage image=typ úložného obrazu
Unknown action=Neznámá akce
Unknown version=Neznámá verze
Unraid Mount tag=Značka připojení Unraidu
Unraid Share=Sdílení Unraid
Updating=Aktualizuji
USB Controller=USB řadič
USB Devices=USB zařízení
vDisk Bus=Sběrnice vDisku
vDisk Location=Umístění vDisku
vDisk Size=Velikost vDisku
vDisk Type=Typ vDisku
vDisks=vDisky
Verifying=Ověřuji
video for VNC=video pro VNC
VirtIO Drivers CDRom Bus=Ovladače VirtIO sběrnice CD-Rom
VirtIO Drivers ISO=ISO obraz ovladačů VirtIO
Virtual Machines=Virtuální stroje
VM creation error=Chyba při vytváření virtuálního stroje
VM image deletion error=Chyba při mazání virtuálního stroje
VNC Keyboard=VNC klávesnice
VNC Password=VNC heslo
VNC Video Driver=VNC video ovladač
VNC=VNC
Wasnt able to stop the process=Nemohu zastavit proces
Windows 7XP=Windows 7/XP
Windows 82012, newer Linux distros=Windows 8/2012, novější Linuxové distribuce
XML View=XML náhled
